11111111111111111111111111
10000000000000000000000001
10000000000000000000000001
10X000000R0000000000000001
10000000000000000000000001
10000000000000000000000001
10000000000000000000000001
10000000000000000000000001
10000000003330000000000001
10000000003330000000000001
10000000003330000R00000001
10000000000000000000000001
10000000000000000000000001
10000000000000000000000001
10000004444000000000000001
10000005454000000000000001
10000004454000000000000001
10000004004000000000000001
10000000000000000000000001
10000000000000000000000001
10000000000000000000000001
10000000000000000000000001
11111111111111111111111111
