11111111111111111111111111
1BBBBBBBBBBBBBBBBBBBBBBBB1
1BBBBBBBBBBBBBBBBBBBBBBBB1
1BXBBBBBBBBBBBBBBBBBBBBBB1
1BBBBBBBBBBBBBBBBBBBBBBBB1
1BBBBBBBBBBBBBBBBBBBBBBBB1
1BBBBBBBBBBBBBBBBBBBBBBBB1
1BBBBBBBBBBBBBBBBBBBBBBBB1
1BBBBBBBBBBBBBBBBBBBBBBBB1
1BBBBBBBBBBBBBBBBBBBBBBBB1
1BBBBBBBBBBBBBBBBBBBBBBBB1
1BBBBBBBBBBBBBBBBBBBBBBBB1
1BBBBBBBBBBBBBBBBBBBBBBBB1
1BBBBBBBBBBBBBBBBBBBBBBBB1
1BBBBBBBBBBBBBBBBBBBBBBBB1
1BBBBBBBBBBBBBBBBBBBBBBBB1
1BBBBBBBBBBBBBBBBBBBBBBBB1
1BBBBBBBBBBBBBBBBBBBBBBBB1
1BBBBBBBBBBBBBBBBBBBBBBBB1
11111111111111111111111111
