1111111111111111111111111111111111111111111111111111111111111111111111111111111111111111111111111111
1000000000000000000000000000000000000000000000000000000000000000000000000000000000000000000000000001
1000000000000000000000000000000000000000000000000000000000000000000000000000000000000000000000000001
1000000000000000000000000000000000000000000000000000000000000000000000000000000000000000000000000001
1000000000000000000000000000000000000000000000000000000000000000000000000000000000000000000000000001
1000000000000000000000000000000000000000000000000000000000000000000000000000000000000000000000000001
1000000000000000000000000000000000000000000000000000000000000000000000000000000000000000000000000001
1000000000000000000000000000000000000000000000000000000000000000003000000000030000000000000000000001
1000000000000000000000000000000000000001111111111000000000000000003300000000330000000000000000000001
1000000000000000000000000000000000000001MMMMMMMM1000000000000000003030000003030000000000000000000001
1000000000000000000000000000000000000001MMMMMMMM1000000000000000003003333330030000000000000000000001
1000000000000000000000000000000000000001111909111000000000000000003000000000003000000000000000000001
100000000000000000000000000000000000000000000000000000000000000000300M0000M0003000000000000000000001
1000000000000000000000000000000000000000000000000000000000000000030000000000000300000000000000000001
100000066666666006660666660000000000000000000000000000000000000000300000R000003000000000000000000001
1000000500000000000000000500000000000000000000000000000000000000003000000000003000000000000000000001
1000000500000000000C00000500000000000000000000000000000000000000000333390933330000000000000000000001
1000000500005555050050055555500000000000000000000000000000000000000000000000000000000000000000000001
1000005000000000000000000000050000000000000000000000000000000000000000000000000000000000000000000001
100005000R00R0000000000R00R0005000000000000000000000000000000000000000000000000000000000000000000001
1000005000000000000000000000050000000000000000000000000000000000000000000000000000000000000000000001
1000000555555555550555555555500000000000000000000000000000000000000000000000000000000000000000000001
1000000000000000050500000000000000000000000000000000000000000000000000000000000000000000000000000001
1000000000000000050500000000000000000000000000000000000000000000000000000000000000000000000000000001
1000000000000000050500000000000000000000000000000000000000000000000000000000000000000000000000000001
1444444444444444440444444444444444444440000000000000000000000000000000000000000000000000000000000001
1000000000000000000000000000000000000000000000000000000000077777770000000000000000000000000000000001
10000000X00000000000000000000000000000000000000C0000000000070000000000000000000000000000000000000001
1000000000000000000000000000000000000000000000000000000000070000000000000000000000000000000000000001
1000000000000010000000000000000000000000000000000000000000077777770000000000000000000000000000000001
1000000000000000000000000000000000000000000000000000000000000000000000000000000000000000000000000001
1000000000000000000000000000000000000000000000000000000000000000000000000000000000000000000000000001
1111111111111111111111111111111111111111111111111111111111111111111111111111111111111111111111111111
