11111111111111111111111111
1MMMMMMMMMMMMMMMMMMMMMMMM1
1MMMMMMMMMMMMMMMMMMMMMMMM1
1MXMMMMMMMMMMMMMMMMMMMMMM1
1MMMMMMMMMMMMMMMMMMMMMMMM1
1MMMMMMMMMMMMMMMMMMMMMMMM1
1MMMMMMMMMMMMMMMMMMMMMMMM1
1MMMMMMMMMMMMMMMMMMMMMMMM1
1MMMMMMMMMMMMMMMMMMMMMMMM1
1MMMMMMMMMMMMMMMMMMMMMMMM1
1MMMMMMMMMMMMMMMMMMMMMMMM1
1MMMMMMMMMMMMMMMMMMMMMMMM1
1MMMMMMMMMMMMMMMMMMMMMMMM1
1MMMMMMMMMMMMMMMMMMMMMMMM1
1MMMMMMMMMMMMMMMMMMMMMMMM1
1MMMMMMMMMMMMMMMMMMMMMMMM1
1MMMMMMMMMMMMMMMMMMMMMMMM1
1MMMMMMMMMMMMMMMMMMMMMMMM1
1MMMMMMMMMMMMMMMMMMMMMMMM1
11111111111M11111111111111
11111111111M11111111111111
1MMMMMMMMMMMMMMMMMMMMMMMM1
1MMMMMMMMMMMMMMMMMMMMMMMM1
1MMMMMMMMMMMMMMMMMMMMMMMM1
1MMMMMMMMMMMMMMMMMMMMMMMM1
1MMMMMMMMMMMMMMMMMMMMMMMM1
1MMMMMMMMMMMMMMMMMMMMMMMM1
1MMMMMMMMMMMMMMMMMMMMMMMM1
1MMMMMMMMMMMMMMMMMMMMMMMM1
1MMMMMMMMMMMMMMMMMMMMMMMM1
1MMMMMMMMMMMMMMMMMMMMMMMM1
1MMMMMMMMMMMMMMMMMMMMMMMM1
1MMMMMMMMMMMMMMMMMMMMMMMM1
1MMMMMMMMMMMMMMMMMMMMMMMM1
1MMMMMMMMMMMMMMMMMMMMMMMM1
1MMMMMMMMMMMMMMMMMMMMMMMM1
1MMMMMMMMMMMMMMMMMMMMMMMM1
1MMMMMMMMMMMMMMMMMMMMMMMM1
1MMMMMMMMMMMMMMMMMMMMMMMM1
11111111111M11111111111111
11111111111M11111111111111
1MMMMMMMMMMMMMMMMMMMMMMMM1
1MMMMMMMMMMMMMMMMMMMMMMMM1
1MMMMMMMMMMMMMMMMMMMMMMMM1
1MMMMMMMMMMMMMMMMMMMMMMMM1
1MMMMMMMMMMMMMMMMMMMMMMMM1
1MMMMMMMMMMMMMMMMMMMMMMMM1
1MMMMMMMMMMMMMMMMMMMMMMMM1
1MMMMMMMMMMMMMMMMMMMMMMMM1
1MMMMMMMMMMMMMMMMMMMMMMMM1
1MMMMMMMMMMMMMMMMMMMMMMMM1
1MMMMMMMMMMMMMMMMMMMMMMMM1
1MMMMMMMMMMMMMMMMMMMMMMMM1
1MMMMMMMMMMMMMMMMMMMMMMMM1
1MMMMMMMMMMMMMMMMMMMMMMMM1
1MMMMMMMMMMMMMMMMMMMMMMMM1
1MMMMMMMMMMMMMMMMMMMMMMMM1
1MMMMMMMMMMMMMMMMMMMMMMMM1
1MMMMMMMMMMMMMMMMMMMMMMMM1
11111111111111111111111111
