111111
1X0001
100001
100101
100001
111111
